A-B 1 A B 1 1 0
B-C 1 B C 1 1 1
C-D 1 C D 1 1 2
D-E 1 D E 1 1 3
E-F 1 E F 1 1 4
F-G 1 F G 1 1 5
G-H 1 G H 1 1 6
H-I 1 H I 1 1 7

SIDE 1 X B 1 3 0

EXTRA 1 Y Z 3 1000 0
